0 0 0 0 0 0 0 0 0 0
0 M M M 0 0 0 0 0 0
0 M L L 0 0 0 0 0 0
0 0 0 L 0 0 0 0 0 0
0 0 L 0 0 M 0 0 0 0

L --> LAND
M --> MOUNTAIN
0 --> BLACK IN MAP